XXXXXXXXXXXXXXXXXXXXXXXXXXXXXXX
P         X           X   X   X
X X X X X XXX X XXXXXXX X X X X
X X X X X     X X   X   X   X X
X X X X XXX X XXX X X XXX XXX X
X X X X X X X X   X   X       X
X XXX X X X X X XXX XXX XXX X X
X     X X   X X       X X   X X
X XXXXX X XXX XXXXXXX X XXXXX X
X   X X X     X     X X X     X
XXX X X X XXX X XXX X X X XXXXX
X   X X X X   X X X   X       X
X XXX X XXX X X X XXXXX X XXX X
X           X     X     X X   X
XXXXX XXXXXXXXXXX XXX X X X XXX
X   X       X   X     X X X   X
X XXXXXXXXX X X XXXXXXX X XXX X
X X   X     X X     X X X   X X
X X X X X XXX XXXXX X X X XXX X
X   X   X   X X   X       X   X
X XXXXXXX X X X XXXXXXXXX X X X
X X       X   X           X X X
X X XXX X XXXXXXXXX XXXXX X XXX
X   X X X               X X   X
XXXXX X XXXXXXXXX XXXXX X XXX X
X     X X   X     X     X X   X
X X XXX XXX X XXX X XXX X X XXX
X X X   X   X             X   X
X XXX XXX X XXXXX XXX XXXXXXX X
X         X         X         K
XXXXXXXXXXXXXXXXXXXXXXXXXXXXXXX
